티커,종목명,시가,종가,변동폭,등락률,거래량,거래대금
095570,AJ네트웍스,8030,8390,360,4.48,1809512,14437661840
006840,AK홀딩스,16350,16450,100,0.61,175328,2893172000
027410,BGF,4215,4245,30,0.71,1723346,7370311660
282330,BGF리테일,181000,171500,-9500,-5.25,808391,140089235500
138930,BNK금융지주,6790,6850,60,0.88,14517931,98746067580
001460,BYC,424500,414000,-10500,-2.47,1197,493580500
001465,BYC우,159000,153500,-5500,-3.46,1044,161978500
001040,CJ,79800,81000,1200,1.5,417753,33333859600
079160,CJCGV,20800,21100,300,1.44,2355045,50316926800
00104K,CJ4우전환,71400,71900,500,0.7,59807,4249111600
000120,CJ대한통운,116500,124500,8000,6.87,749838,90920511500
011150,CJ씨푸드,3295,3465,170,5.16,3357409,11594444560
011155,CJ씨푸드1우,27850,28750,900,3.23,1833,51504000
001045,CJ우,48100,50200,2100,4.37,35641,1743806350
097950,CJ제일제당,391500,416000,24500,6.26,739398,305798799750
097955,CJ제일제당우,169000,174500,5500,3.25,22958,4020067000
000590,CS홀딩스,66000,74800,8800,13.33,207508,15128136200
012030,DB,830,835,5,0.6,3342587,2769704254
016610,DB금융투자,5180,5060,-120,-2.32,463259,2391319930
005830,DB손해보험,60600,63800,3200,5.28,2220798,140430388490
000990,DB하이텍,45000,45200,200,0.44,10314140,457197994300
000995,DB하이텍1우,83900,86100,2200,2.62,28472,2573538900
139130,DGB금융지주,7720,7590,-130,-1.68,7044656,53538104160
001530,DI동일,18200,19750,1550,8.52,1459097,28244083950
000210,DL,65000,67100,2100,3.23,1752076,119096957300
001880,DL건설,21200,21300,100,0.47,423257,9267683650
000215,DL우,38650,39850,1200,3.1,40039,1592417800
375500,DL이앤씨,40550,42450,1900,4.69,3696177,159175024100
37550L,DL이앤씨2우전환,33900,34800,900,2.65,38108,1314469850
37550K,DL이앤씨우,28500,30250,1750,6.14,56271,1662727800
007340,DN오토모티브,57300,67000,9700,16.93,414354,25778265300
004840,DRB동일,4530,4660,130,2.87,224448,1034145885
155660,DSR,5740,5880,140,2.44,1053423,6356283880
069730,DSR제강,5020,5170,150,2.99,1239349,6568785910
017940,E1,44650,47200,2550,5.71,116767,5309757000
365550,ESR켄달스퀘어리츠,5190,5550,360,6.94,2182464,11939063713
383220,FF,149500,151500,2000,1.34,2092586,322412117000
007700,FF홀딩스,18950,19850,900,4.75,640346,12767430000
114090,GKL,14350,15400,1050,7.32,4074714,61076047650
078930,GS,41650,44350,2700,6.48,2184178,92069103400
006360,GS건설,29800,30950,1150,3.86,9615489,302168702350
001250,GS글로벌,3585,3670,85,2.37,111257420,421811122775
007070,GS리테일,24550,25500,950,3.87,2802549,70935981400
078935,GS우,34500,35800,1300,3.77,46611,1622045100
012630,HDC,6960,7030,70,1.01,737967,5134544480
039570,HDC랩스,8770,8710,-60,-0.68,292800,2563402610
089470,HDC현대EP,4070,4475,405,9.95,492730,2134740415
294870,HDC현대산업개발,12350,12600,250,2.02,4936651,63158115300
267250,HD현대,56900,59200,2300,4.04,1552244,89642944700
097230,HJ중공업,6900,6700,-200,-2.9,221507,1515041420
003580,HLB글로벌,9410,8880,-530,-5.63,7735672,73618356080
011200,HMM,24850,23250,-1600,-6.44,27191650,670852373300
082740,HSD엔진,8860,9110,250,2.82,8710509,79297719140
003560,IHQ,753,697,-56,-7.44,6148996,4474207776
175330,JB금융지주,7460,7740,280,3.75,4579940,34130701540
234080,JW생명과학,13800,13200,-600,-4.35,194535,2647093450
001060,JW중외제약,23850,22600,-1250,-5.24,952356,22119585900
001067,JW중외제약2우B,71400,71500,100,0.14,1350,95835900
001065,JW중외제약우,35700,36900,1200,3.36,3278,118716600
096760,JW홀딩스,3475,3400,-75,-2.16,416622,1440884850
105560,KB금융,48450,50800,2350,4.85,14747093,742233088354
002380,KCC,291500,300500,9000,3.09,532130,162162565500
344820,KCC글라스,47850,51500,3650,7.63,255990,12680811200
009070,KCTC,4755,5020,265,5.57,10061010,53786955800
009440,KC그린홀딩스,4955,4010,-945,-19.07,2445316,10792819805
119650,KC코트렐,4375,4150,-225,-5.14,1098759,4905602865
092220,KEC,2725,2920,195,7.16,49401772,142401186385
016380,KG스틸,12250,12400,150,1.22,8454995,106931824200
001390,KG케미칼,28100,27150,-950,-3.38,2318200,65859925750
033180,KH필룩스,1450,1555,105,7.24,20871184,32997594270
001940,KISCO홀딩스,14150,13950,-200,-1.41,374256,5311350800
025000,KPX케미칼,49300,49700,400,0.81,39947,2025441500
092230,KPX홀딩스,60300,60600,300,0.5,9886,597062200
000040,KR모터스,728,711,-17,-2.34,5049912,3617570767
044450,KSS해운,10250,10800,550,5.37,480065,5068796500
030200,KT,37750,38650,900,2.38,10251970,390920085725
033780,KTG,81900,81600,-300,-0.37,2835207,230465347900
058850,KTcs,2190,2405,215,9.82,3903819,9140665050
058860,KTis,2675,2835,160,5.98,2015847,5585475405
093050,LF,17450,17350,-100,-0.57,557150,9524676800
003550,LG,81100,83800,2700,3.33,2424616,199534038608
034220,LG디스플레이,15300,16900,1600,10.46,17818228,287009194800
051900,LG생활건강,779000,714000,-65000,-8.34,481746,361198288295
051905,LG생활건강우,378500,357500,-21000,-5.55,38878,14460934500
373220,LG에너지솔루션,422000,447000,25000,5.92,5726174,2562523399000
003555,LG우,62600,64500,1900,3.04,37423,2377574700
032640,LG유플러스,12500,12350,-150,-1.2,8409349,105149927000
011070,LG이노텍,363000,338500,-24500,-6.75,2459463,854826558250
066570,LG전자,94400,101000,6600,6.99,12052457,1187182010700
066575,LG전자우,46300,48850,2550,5.51,312622,15028114150
037560,LG헬로비전,5700,5220,-480,-8.42,9008703,50650966980
051910,LG화학,603000,640000,37000,6.14,3015852,1934006408748
051915,LG화학우,291000,308500,17500,6.01,196716,61282306500
079550,LIG넥스원,88000,90900,2900,3.3,4321783,390004650400
006260,LS,58900,64200,5300,9.0,1695668,104505779600
010120,LSELECTRIC,58000,56900,-1100,-1.9,1789536,103076419900
000680,LS네트웍스,3060,3005,-55,-1.8,928641,2895068535
229640,LS전선아시아,7310,7330,20,0.27,1215544,8941246520
001120,LX인터내셔널,32800,37050,4250,12.96,3802374,129996517400
108670,LX하우시스,43500,46450,2950,6.78,481049,22058919700
108675,LX하우시스우,19600,22000,2400,12.24,41865,888601850
383800,LX홀딩스,8730,8680,-50,-0.57,2501191,21749776180
38380K,LX홀딩스1우,11950,12000,50,0.42,40375,488583900
023150,MH에탄올,8970,8830,-140,-1.56,434991,3910572860
035420,NAVER,259000,248000,-11000,-4.25,9002675,2364275610859
181710,NHN,27300,28050,750,2.75,1232275,35450296950
400760,NH올원리츠,4570,4700,130,2.84,485329,2243858125
005940,NH투자증권,9950,9990,40,0.4,6180201,61843064980
005945,NH투자증권우,9760,10000,240,2.46,471881,4663092470
338100,NH프라임리츠,4785,4730,-55,-1.15,253894,1193418925
034310,NICE,14050,13700,-350,-2.49,1113622,15059894700
008260,NI스틸,4995,4560,-435,-8.71,2314900,11249015800
004250,NPC,9420,9280,-140,-1.49,12636189,121626090880
004255,NPC우,4960,4920,-40,-0.81,2773477,14324792265
010060,OCI,122500,122000,-500,-0.41,7872202,966994938000
178920,PI첨단소재,37200,37650,450,1.21,1686180,64346078400
005490,POSCO홀딩스,242000,255000,13000,5.37,4356216,1077867091380
010950,S-Oil,91800,94000,2200,2.4,7750978,688147778646
010955,S-Oil우,58400,61100,2700,4.62,234595,13631639900
034120,SBS,42150,41150,-1000,-2.37,777171,32582051900
005090,SGC에너지,34900,39700,4800,13.75,950746,36455944200
001380,SG글로벌,1465,1500,35,2.39,2289920,3502034840
004060,SG세계물산,589,610,21,3.57,10315828,6371572414
001770,SHD,31000,34150,3150,10.16,165291,5454887550
002360,SH에너지화학,1040,1225,185,17.79,103139229,119049630365
009160,SIMPAC,6480,6460,-20,-0.31,1835840,11986353930
123700,SJM,3660,3545,-115,-3.14,167734,605382215
025530,SJM홀딩스,3050,3105,55,1.8,594355,1882099280
034730,SK,220000,231500,11500,5.23,1711095,385401717000
011790,SKC,136000,128000,-8000,-5.88,3111885,418968158000
018670,SK가스,112500,118500,6000,5.33,204630,23664954500
001740,SK네트웍스,4345,4270,-75,-1.73,6124613,27065695475
001745,SK네트웍스우,58700,61600,2900,4.94,3054,188953800
006120,SK디스커버리,36000,36350,350,0.97,200716,7290058300
006125,SK디스커버리우,30800,31300,500,1.62,19172,597063550
210980,SK디앤디,25750,27850,2100,8.16,314553,8700322950
068400,SK렌터카,8480,8740,260,3.07,3390791,31874272990
395400,SK리츠,5330,5560,230,4.32,2356875,12813187760
302440,SK바이오사이언스,122000,116500,-5500,-4.51,6986619,878743669500
326030,SK바이오팜,78000,76900,-1100,-1.41,1737241,136891311600
402340,SK스퀘어,42750,42950,200,0.47,3865622,165331291352
361610,SK아이이테크놀로지,81800,89700,7900,9.66,6667186,594864283500
03473K,SK우,191000,198000,7000,3.66,10572,2086690000
096770,SK이노베이션,187500,204500,17000,9.07,5371508,1056779891550
096775,SK이노베이션우,117000,125000,8000,6.84,60400,7478219000
001510,SK증권,761,766,5,0.66,10109874,7759236606
001515,SK증권우,3015,3130,115,3.81,52520,161489080
285130,SK케미칼,105000,99000,-6000,-5.71,773771,80956844800
28513K,SK케미칼우,52500,53500,1000,1.9,79727,4258762700
017670,SK텔레콤,53600,51000,-2600,-4.85,7858936,409163154062
000660,SK하이닉스,97900,96400,-1500,-1.53,37286745,3559370003488
064960,SNT모티브,43950,43050,-900,-2.05,502739,21575639150
100840,SNT에너지,16650,20850,4200,25.23,2496686,51192520350
003570,SNT중공업,8380,9720,1340,15.99,4897624,44309288340
036530,SNT홀딩스,15700,15950,250,1.59,260844,4091160700
005610,SPC삼립,79000,87700,8700,11.01,241683,20489951100
011810,STX,3270,3630,360,11.01,721859,2580215475
077970,STX엔진,13950,15450,1500,10.75,2295719,35204953100
071970,STX중공업,4230,4905,675,15.96,1526825,7242926810
002820,SUNL,4735,4285,-450,-9.5,209024,932172505
084870,TBH글로벌,1990,2000,10,0.5,559622,1117940575
002710,TCC스틸,13950,12700,-1250,-8.96,8600345,117180225300
069260,TKG휴켐스,20100,20350,250,1.24,2324286,47056139100
002900,TYM,2760,2495,-265,-9.6,70100725,177973733895
024070,WISCOM,3200,3175,-25,-0.78,227133,724486385
037270,YGPLUS,6280,6460,180,2.87,13140515,87687360600
000500,가온전선,23750,22250,-1500,-6.32,428714,9260590800
000860,강남제비스코,23100,23150,50,0.22,118328,2763703050
035250,강원랜드,25900,26550,650,2.51,5764402,148461898300
011420,갤럭시아에스엠,2000,2035,35,1.75,2330822,4770442400
002100,경농,11150,11450,300,2.69,920398,10660619650
009450,경동나비엔,39900,39600,-300,-0.75,821086,32250524550
267290,경동도시가스,21850,24900,3050,13.96,941972,22251248950
012320,경동인베스트,36000,34350,-1650,-4.58,68332,2379873000
000050,경방,13150,12450,-700,-5.32,73483,950262650
214390,경보제약,7180,7050,-130,-1.81,159214,1134644710
012610,경인양행,5850,5800,-50,-0.85,2549485,15284757200
009140,경인전자,26650,27900,1250,4.69,41562,1141043350
013580,계룡건설,24500,24050,-450,-1.84,649877,16523783900
012200,계양전기,3140,3260,120,3.82,1992202,6500477300
012205,계양전기우,5640,5560,-80,-1.42,73179,420763170
002140,고려산업,5310,6070,760,14.31,72885817,440020894680
010130,고려아연,477500,587000,109500,22.93,961055,527090016500
002240,고려제강,21000,20700,-300,-1.43,728225,15667893250
009290,광동제약,6490,6930,440,6.78,8973706,62395568810
017040,광명전기,3115,2785,-330,-10.59,9365198,27590209960
017900,광전자,2420,2470,50,2.07,1105741,2678495335
037710,광주신세계,32850,33500,650,1.98,157490,5335222400
030610,교보증권,6460,6420,-40,-0.62,304397,1958048930
339770,교촌에프앤비,12300,12000,-300,-2.44,345379,4176573950
007690,국도화학,50700,51600,900,1.78,276917,14199694850
005320,국동,1745,1615,-130,-7.45,7742256,13833930885
001140,국보,1145,1045,-100,-8.73,17455186,18613234555
002720,국제약품,5500,5540,40,0.73,3605259,20821860090
083420,그린케미칼,8560,8850,290,3.39,13522642,125105899230
014530,극동유화,3725,3910,185,4.97,1832990,6922714610
014280,금강공업,7170,7150,-20,-0.28,1445709,10560335030
014285,금강공업우,12800,13200,400,3.13,15807,207275450
008870,금비,76000,72300,-3700,-4.87,30559,2323432600
001570,금양,8540,10000,1460,17.1,201705749,1917703890760
002990,금호건설,8300,8700,400,4.82,924579,8006140620
002995,금호건설우,28250,28350,100,0.35,2288,65271850
011780,금호석유,129500,130500,1000,0.77,834495,109959405500
011785,금호석유우,87300,93600,6300,7.22,100851,9132653200
214330,금호에이치티,1280,1150,-130,-10.16,16103615,20211690570
001210,금호전기,1390,1375,-15,-1.08,2252552,3167835875
073240,금호타이어,3555,3710,155,4.36,3651590,13476980455
092440,기신정기,3680,3770,90,2.45,206519,769163140
000270,기아,81200,77200,-4000,-4.93,17195073,1376383438364
024110,기업은행,9390,9770,380,4.05,10054359,96216894030
013700,까뮤이앤씨,2300,2250,-50,-2.17,19481531,47365576370
004540,깨끗한나라,3625,3740,115,3.17,7820537,31359019915
004545,깨끗한나라우,19550,19250,-300,-1.53,10208,207677000
001260,남광토건,10550,10600,50,0.47,1430252,16183638000
008350,남선알미늄,2315,2300,-15,-0.65,50125636,118785411860
008355,남선알미우,23950,23850,-100,-0.42,69894,1746702150
004270,남성,2450,2430,-20,-0.82,775949,1900746720
003920,남양유업,369000,386500,17500,4.74,9949,3794078000
003925,남양유업우,205500,211500,6000,2.92,1435,302786000
025860,남해화학,9700,9890,190,1.96,7088271,70301801930
005720,넥센,3615,3800,185,5.12,504788,1896138060
005725,넥센우,2915,2955,40,1.37,69444,207225605
002350,넥센타이어,6190,6630,440,7.11,2026509,13294442740
002355,넥센타이어1우B,2745,2925,180,6.56,198778,573983175
251270,넷마블,72100,66800,-5300,-7.35,3862660,268839029700
090350,노루페인트,9070,9430,360,3.97,2939994,28568099910
090355,노루페인트우,16400,16600,200,1.22,11956,199578600
000320,노루홀딩스,11150,11700,550,4.93,252526,2940901100
000325,노루홀딩스우,24400,20800,-3600,-14.75,89956,1929499100
006280,녹십자,173000,166500,-6500,-3.76,395620,68165692000
005250,녹십자홀딩스,20600,19700,-900,-4.37,1317763,27510182950
005257,녹십자홀딩스2우,59800,53700,-6100,-10.2,43653,2590574300
004370,농심,279500,300000,20500,7.33,385000,111986423500
072710,농심홀딩스,67800,68400,600,0.88,37688,2562903200
058730,다스코,5400,5800,400,7.41,34812111,211455134050
030210,다올투자증권,4535,4990,455,10.03,2161510,10168986110
023590,다우기술,18800,19050,250,1.33,537086,10181970500
145210,다이나믹디자인,4625,4650,25,0.54,155546,734578150
019680,대교,3080,3085,5,0.16,1257382,3984131920
019685,대교우B,2390,2290,-100,-4.18,259995,606923800
006370,대구백화점,10800,10950,150,1.39,34021,359986200
008060,대덕,6680,6730,50,0.75,776699,5227126140
00806K,대덕1우,9250,9210,-40,-0.43,18066,166037880
353200,대덕전자,28450,27950,-500,-1.76,9249168,264125976200
35320K,대덕전자1우,12700,12750,50,0.39,94782,1201095350
000490,대동,12850,12850,0,0.0,6009656,75462890250
008110,대동전자,9150,18750,9600,104.92,51316061,713255299420
005750,대림BCo,5100,5360,260,5.1,6536510,39817426895
006570,대림통상,3615,3610,-5,-0.14,461993,1855859330
001680,대상,21800,24000,2200,10.09,2207607,51409247150
001685,대상우,16200,17000,800,4.94,86360,1441581450
084690,대상홀딩스,8280,8800,520,6.28,826899,7146053350
084695,대상홀딩스우,9720,10500,780,8.02,271840,2855676010
128820,대성산업,5160,5010,-150,-2.91,7707924,39703508350
117580,대성에너지,11400,14650,3250,28.51,35800616,503849448950
016710,대성홀딩스,82000,88200,6200,7.56,1369793,118219366100
003540,대신증권,15450,15700,250,1.62,464094,7143286150
003547,대신증권2우B,13550,14150,600,4.43,138632,1906760700
003545,대신증권우,14100,14550,450,3.19,460663,6564899100
009190,대양금속,3680,3905,225,6.11,8575568,34420607605
014160,대영포장,1750,1765,15,0.86,5174105,9258953655
047040,대우건설,5250,5290,40,0.76,27691310,149745759750
009320,대우부품,1945,2080,135,6.94,9427307,20889290010
042660,대우조선해양,19850,20950,1100,5.54,6194583,130176055500
003090,대웅,28250,25800,-2450,-8.67,455779,12429253950
069620,대웅제약,183500,169500,-14000,-7.63,456669,82053011500
000430,대원강업,3160,3175,15,0.47,4883938,16779770400
006340,대원전선,1540,1525,-15,-0.97,4932065,7673205795
006345,대원전선우,2615,2730,115,4.4,50820,137984470
003220,대원제약,17700,17300,-400,-2.26,2680668,48717565100
024890,대원화성,3085,3020,-65,-2.11,14640041,47508720150
002880,대유에이텍,859,897,38,4.42,6206222,5530833516
000300,대유플러스,947,1050,103,10.88,22187958,22408883728
012800,대창,1495,1480,-15,-1.0,5345543,8165044105
015230,대창단조,5320,5580,260,4.89,3285845,18267260160
001070,대한방직,49000,51700,2700,5.51,59313,3002165450
006650,대한유화,127000,126500,-500,-0.39,383349,48915082000
001440,대한전선,1760,1785,25,1.42,119375486,216254173350
084010,대한제강,15750,15200,-550,-3.49,1156588,18488117550
001790,대한제당,3080,3130,50,1.62,11745117,36453807020
001795,대한제당우,2890,3000,110,3.81,3981481,12485568420
001130,대한제분,142500,149500,7000,4.91,46106,6653065500
003490,대한항공,25300,26200,900,3.56,21045650,548162186100
003495,대한항공우,31700,32850,1150,3.63,82110,2788187600
005880,대한해운,2385,2450,65,2.73,10094483,24915426205
003830,대한화섬,107500,111000,3500,3.26,5304,576942500
016090,대현,2180,2340,160,7.34,4186205,9745110960
069460,대호에이엘,2300,2095,-205,-8.91,14884920,31875650950
192080,더블유게임즈,42250,41000,-1250,-2.96,884013,36060281550
012510,더존비즈온,32150,35050,2900,9.02,1262392,42335081950
004830,덕성,6400,6000,-400,-6.25,1387295,8728462810
004835,덕성우,7300,7000,-300,-4.11,125893,908739380
024900,덕양산업,2700,3040,340,12.59,5864432,17919329535
145720,덴티움,85400,88600,3200,3.75,2471768,237206190200
002150,도화엔지니어링,8910,9020,110,1.23,7773637,73370712550
001230,동국제강,13250,13450,200,1.51,7151694,97554319300
023450,동남합성,58200,58900,700,1.2,11362,664396300
004140,동방,2870,2965,95,3.31,13598242,43417382470
007590,동방아그로,7030,7050,20,0.28,268335,1917202310
005960,동부건설,10800,11100,300,2.78,599011,6818714550
005965,동부건설우,26000,28750,2750,10.58,8806,243585450
026960,동서,25300,25550,250,0.99,554273,14086812200
002210,동성제약,7820,7860,40,0.51,1010791,8327110160
102260,동성케미컬,4395,4670,275,6.26,535818,2425248065
000640,동아쏘시오홀딩스,99800,107000,7200,7.21,109061,11573817500
170900,동아에스티,61600,57900,-3700,-6.01,80528,4786067100
028100,동아지질,17050,17100,50,0.29,1031797,18761162850
282690,동아타이어,11950,12750,800,6.69,120896,1495633900
001520,동양,1195,1155,-40,-3.35,5588127,6659698885
001527,동양2우B,13250,12900,-350,-2.64,13000,168185950
084670,동양고속,16250,16050,-200,-1.23,7968,129342350
082640,동양생명,5400,5670,270,5.0,1122314,6186982100
001525,동양우,6400,6400,0,0.0,28868,183523490
008970,동양철관,1080,1150,70,6.48,48418639,57111457870
092780,동양피스톤,5180,5000,-180,-3.47,570371,2944424170
049770,동원FB,152000,166000,14000,9.21,48874,7882751000
018500,동원금속,906,945,39,4.3,1397716,1287524521
006040,동원산업,224500,234000,9500,4.23,51002,11691946000
030720,동원수산,9780,10250,470,4.81,1324754,13506301760
014820,동원시스템즈,54400,57900,3500,6.43,473010,27354835500
014825,동원시스템즈우,33100,33900,800,2.42,2805,94594000
163560,동일고무벨트,6910,7020,110,1.59,532466,3762473560
004890,동일산업,180000,180500,500,0.28,12935,2328480500
002690,동일제강,3300,3205,-95,-2.88,3408453,11610549740
000020,동화약품,10550,10200,-350,-3.32,1389020,14639968850
000150,두산,69900,83600,13700,19.6,1584330,124276190500
000157,두산2우B,93400,100000,6600,7.07,43549,4460912200
241560,두산밥캣,31100,33400,2300,7.4,3912161,125325152750
034020,두산에너빌리티,18750,21150,2400,12.8,75811065,1542390084950
000155,두산우,46750,54700,7950,17.01,48873,2481513800
336260,두산퓨얼셀,32900,37800,4900,14.89,13596360,524984855900
33626K,두산퓨얼셀1우,10300,11800,1500,14.56,6538679,86403307450
33626L,두산퓨얼셀2우B,13250,14850,1600,12.08,3080003,51208233500
016740,두올,3010,2860,-150,-4.98,1001083,2958422725
192650,드림텍,9300,9280,-20,-0.22,2367746,22166899310
024090,디씨엠,20350,20150,-200,-0.98,477227,9638807050
003160,디아이,6470,6240,-230,-3.55,1075185,6893276860
092200,디아이씨,4545,4285,-260,-5.72,1518443,6784927345
377190,디앤디플랫폼리츠,4525,4625,100,2.21,1129543,5180843435
013570,디와이,7260,7000,-260,-3.58,2490121,18147039020
210540,디와이파워,12200,11700,-500,-4.1,783721,9594880700
115390,락앤락,8250,8090,-160,-1.94,738741,6046059650
032350,롯데관광개발,11700,11650,-50,-0.43,4733271,55882220700
089860,롯데렌탈,39650,37100,-2550,-6.43,1150612,43936210350
330590,롯데리츠,5080,5140,60,1.18,3567886,18085108768
000400,롯데손해보험,1680,1650,-30,-1.79,2987690,5102909125
023530,롯데쇼핑,95400,100000,4600,4.82,975794,96451721600
004000,롯데정밀화학,65800,70400,4600,6.99,2318792,159317236400
286940,롯데정보통신,27350,27400,50,0.18,444082,12125134000
280360,롯데제과,117500,124500,7000,5.96,153054,18553756000
004990,롯데지주,37350,39250,1900,5.09,2270464,86875703950
00499K,롯데지주우,48600,50800,2200,4.53,73981,3960397750
005300,롯데칠성,177500,159000,-18500,-10.42,705644,117558509000
005305,롯데칠성우,73400,69800,-3600,-4.9,24837,1759183700
011170,롯데케미칼,176500,183000,6500,3.68,1341438,243085632000
071840,롯데하이마트,17200,16700,-500,-2.91,282208,4756558200
027740,마니커,1385,1425,40,2.89,5277086,7491962475
357430,마스턴프리미어리츠,4940,4980,40,0.81,136592,681858950
204320,만도,57200,54700,-2500,-4.37,3441034,192016406100
001080,만호제강,24000,28550,4550,18.96,109643,2887251800
088980,맥쿼리인프라,13000,12850,-150,-1.15,9285411,120000613300
094800,맵스리얼티1,4440,4540,100,2.25,261661,1174418570
138040,메리츠금융지주,26250,31300,5050,19.24,1994812,57372289900
008560,메리츠증권,4850,4920,70,1.44,6895257,33502676595
000060,메리츠화재,34500,39200,4700,13.62,1850660,67585897850
090370,메타랩스,745,746,1,0.13,3159038,2341826150
017180,명문제약,3290,3370,80,2.43,835643,2840825805
009900,명신산업,18300,21350,3050,16.67,10542002,226098793600
012690,모나리자,3460,3550,90,2.6,17521535,66630111660
005360,모나미,3730,4000,270,7.24,13560609,55954510480
204210,모두투어리츠,4730,4855,125,2.64,52159,248608575
009680,모토닉,8600,8670,70,0.81,162477,1398265550
009580,무림PP,4490,4540,50,1.11,5675792,26483492085
009200,무림페이퍼,2710,2645,-65,-2.4,5413953,14800795355
033920,무학,6990,6670,-320,-4.58,1274878,8958188450
008420,문배철강,3755,3975,220,5.86,27554088,117292682630
025560,미래산업,10550,10400,-150,-1.42,488318,5399796950
007120,미래아이앤지,335,333,-2,-0.6,32230044,12217310250
396690,미래에셋글로벌리츠,4815,4925,110,2.28,544409,2660803955
357250,미래에셋맵스리츠,4410,4400,-10,-0.23,319619,1407449905
085620,미래에셋생명,3055,3080,25,0.82,443735,1389295505
006800,미래에셋증권,6590,6650,60,0.91,8915093,59089525130
00680K,미래에셋증권2우B,3930,3965,35,0.89,1447685,5660961765
006805,미래에셋증권우,4600,4865,265,5.76,112987,545575885
002840,미원상사,180500,180500,0,0.0,27110,4861843000
268280,미원에스씨,194500,194000,-500,-0.26,14667,2822697500
107590,미원홀딩스,132000,137000,5000,3.79,5311,718109500
134380,미원화학,66400,67100,700,1.05,3712,248046300
003650,미창석유,80300,79000,-1300,-1.62,16796,1363422000
155900,바다로19호,3355,3380,25,0.75,215887,722919930
003610,방림,3460,4135,675,19.51,4040167,15770898895
001340,백광산업,4405,4570,165,3.75,9599868,44737032245
035150,백산,10300,9870,-430,-4.17,4362014,43921641090
002410,범양건영,4465,4720,255,5.71,40563890,219470116185
096300,베트남개발1,207,209,2,0.97,575290,119538819
007210,벽산,2755,2780,25,0.91,12041356,35137898270
002760,보락,1745,1745,0,0.0,2434904,4318517700
003850,보령,11200,10850,-350,-3.13,1368989,15308378300
000890,보해양조,764,758,-6,-0.79,3456710,2664425824
003000,부광약품,9380,9350,-30,-0.32,10450972,101576497840
001270,부국증권,22300,22200,-100,-0.45,8022,179890800
001275,부국증권우,20200,20200,0,0.0,14539,291348100
026940,부국철강,3800,3905,105,2.76,2950540,11924719600
011390,부산산업,88200,87800,-400,-0.45,47831,4273294000
005030,부산주공,838,772,-66,-7.88,25441810,20571457132
002070,비비안,1800,1805,5,0.28,12090006,24105279155
100220,비상교육,6530,6510,-20,-0.31,771308,5154264110
030790,비케이탑스,904,904,0,0.0,0,0
005180,빙그레,47850,47300,-550,-1.15,107592,5112154500
003960,사조대림,24950,28050,3100,12.42,392713,10473265800
008040,사조동아원,1430,1445,15,1.05,41134554,58249583855
007160,사조산업,43600,46250,2650,6.08,125608,5714912000
014710,사조씨푸드,5730,6140,410,7.16,9664389,57692426800
006090,사조오양,9070,9400,330,3.64,274741,2565809130
001470,삼부토건,2015,2050,35,1.74,73506651,158351801170
006400,삼성SDI,569000,618000,49000,8.61,3033347,1828509356965
006405,삼성SDI우,293500,309000,15500,5.28,33691,10330798000
006660,삼성공조,10350,12200,1850,17.87,1977699,25237187100
028260,삼성물산,120500,120000,-500,-0.41,3469405,421371502750
02826K,삼성물산우B,112000,107000,-5000,-4.46,58020,6420969000
207940,삼성바이오로직스,865000,868000,3000,0.35,721901,639202768300
032830,삼성생명,60700,62200,1500,2.47,2095786,128429924470
018260,삼성에스디에스,136000,133500,-2500,-1.84,1526854,202707453500
028050,삼성엔지니어링,19600,22450,2850,14.54,16541063,349275836250
009150,삼성전기,142500,136500,-6000,-4.21,6045969,829837522000
009155,삼성전기우,79200,77500,-1700,-2.15,44657,3469977900
005930,삼성전자,61400,60900,-500,-0.81,176488577,10695377754794
005935,삼성전자우,57000,55800,-1200,-2.11,10843125,602297154850
001360,삼성제약,3460,3750,290,8.38,17625852,70965914260
010140,삼성중공업,5620,6010,390,6.94,50977410,301157524800
010145,삼성중공우,224000,226000,2000,0.89,6533,1486889000
016360,삼성증권,35000,35000,0,0.0,2909619,102235592400
068290,삼성출판사,26450,30200,3750,14.18,2493840,72825344100
029780,삼성카드,32050,31600,-450,-1.4,779822,24800327450
000810,삼성화재,197500,201000,3500,1.77,1077451,216174139768
000815,삼성화재우,157500,160500,3000,1.9,78926,12521426500
006110,삼아알미늄,19950,24900,4950,24.81,4236517,97801680750
145990,삼양사,42200,43050,850,2.01,154829,6636851900
145995,삼양사우,33950,35000,1050,3.09,3362,117614000
003230,삼양식품,103000,115500,12500,12.14,1614126,181736107500
002170,삼양통상,53700,53100,-600,-1.12,14796,790944000
272550,삼양패키징,19350,20050,700,3.62,86605,1716886850
000070,삼양홀딩스,75000,73500,-1500,-2.0,236145,17513347900
000075,삼양홀딩스우,60600,60300,-300,-0.5,923,55184200
002810,삼영무역,13650,13500,-150,-1.1,88341,1199630200
005680,삼영전자,10800,11100,300,2.78,480655,5146360050
003720,삼영화학,3025,2985,-40,-1.32,29681811,95439705280
023000,삼원강재,2725,2860,135,4.95,506058,1451322025
004380,삼익THK,13400,13700,300,2.24,1868453,26361580200
002450,삼익악기,1595,1435,-160,-10.03,3407661,5139878295
004440,삼일씨엔에스,7570,8200,630,8.32,1314844,12112696360
000520,삼일제약,8140,8230,90,1.11,1032366,8488642170
009770,삼정펄프,26850,32600,5750,21.42,1554214,47593278900
005500,삼진제약,24650,24750,100,0.41,799747,19556318850
004690,삼천리,185000,207000,22000,11.89,308996,60229598500
010960,삼호개발,4040,4180,140,3.47,866530,3662251315
004450,삼화왕관,40750,43550,2800,6.87,1347328,61689103350
009470,삼화전기,18900,21500,2600,13.76,474140,9822052000
011230,삼화전자,3110,3300,190,6.11,393185,1250892755
001820,삼화콘덴서,42800,44350,1550,3.62,459959,20130027150
000390,삼화페인트,7040,7780,740,10.51,2902685,25164384780
001290,상상인증권,1050,1025,-25,-2.38,9833224,11216637170
041650,상신브레이크,3420,3325,-95,-2.78,302418,1024629735
075180,새론오토모티브,4930,4960,30,0.61,24956,123556425
007540,샘표,52700,53100,400,0.76,807003,44261934800
248170,샘표식품,37050,38500,1450,3.91,988132,39950403900
007860,서연,7000,7000,0,0.0,1449153,10150633000
200880,서연이화,8890,8900,10,0.11,5541299,50269444650
017390,서울가스,240000,261500,21500,8.96,155368,38924386500
004410,서울식품,253,261,8,3.16,115165908,31769711208
004415,서울식품우,3350,3400,50,1.49,69614,243510435
021050,서원,1500,1505,5,0.33,1332428,2024084045
008490,서흥,36300,35000,-1300,-3.58,163368,5920201300
007610,선도전기,3000,3000,0,0.0,0,0
136490,선진,10800,10950,150,1.39,1316127,14401426950
014910,성문전자,1890,1980,90,4.76,1246111,2472659405
014915,성문전자우,8440,8780,340,4.03,4747,41122800
003080,성보화학,3635,3630,-5,-0.14,1502329,5552480510
004980,성신양회,9740,10300,560,5.75,4123719,43797655700
004985,성신양회우,13550,14500,950,7.01,987679,16106021500
011300,성안,728,1030,302,41.48,155821436,162646557052
000180,성창기업지주,2105,2190,85,4.04,4438448,9775861810
002420,세기상사,8880,9110,230,2.59,789789,7551551060
004360,세방,11750,13150,1400,11.91,1094225,13901145150
004365,세방우,6920,7250,330,4.77,20159,142093030
004490,세방전지,53900,53000,-900,-1.67,518683,28197915600
001430,세아베스틸지주,15550,16450,900,5.79,1116780,18819549600
306200,세아제강,157500,169500,12000,7.62,813348,141469237000
003030,세아제강지주,154500,166500,12000,7.77,723233,118857454500
019440,세아특수강,13850,15300,1450,10.47,2600841,42895349300
058650,세아홀딩스,96900,101000,4100,4.23,17889,1957797700
013000,세우글로벌,1695,1740,45,2.65,2525588,4343256245
091090,세원이앤씨,890,866,-24,-2.7,34663024,29873950180
021820,세원정공,8090,8090,0,0.0,0,0
067830,세이브존IC,2965,2890,-75,-2.53,596997,1729374890
033530,세종공업,6060,5930,-130,-2.15,1270004,7759303120
075580,세진중공업,6450,7900,1450,22.48,11796974,86462195300
027970,세하,1405,1380,-25,-1.78,962136,1325807835
308170,센트랄모텍,20300,18600,-1700,-8.37,4198864,79798088650
012600,센트럴인사이트,2490,2490,0,0.0,0,0
068270,셀트리온,190000,201500,11500,6.05,6881499,1398708934552
336370,솔루스첨단소재,41750,44350,2600,6.23,3471977,156936452550
33637K,솔루스첨단소재1우,10100,11100,1000,9.9,304120,3284496500
33637L,솔루스첨단소재2우B,13850,14100,250,1.81,230016,3302121850
248070,솔루엠,21400,21500,100,0.47,1457974,30701077350
004430,송원산업,18900,19150,250,1.32,6522925,123468456900
126720,수산인더스트리,33000,33850,850,2.58,12704990,424872141200
017550,수산중공업,3080,3115,35,1.14,11695740,36132306705
053210,스카이라이프,8980,9090,110,1.22,3923911,37466910580
026890,스틱인베스트먼트,8110,8080,-30,-0.37,9940126,84153104530
134790,시디즈,50500,60000,9500,18.81,920209,51318494750
016590,신대양제지,88400,85300,-3100,-3.51,15511,1347460200
029530,신도리코,31700,32700,1000,3.15,112779,3592971536
004970,신라교역,10700,11500,800,7.48,187867,2076087300
011930,신성이엔지,2065,2300,235,11.38,169207330,397692534330
005390,신성통상,3085,3010,-75,-2.43,5761310,17823455065
004170,신세계,218500,221500,3000,1.37,812116,180238936000
035510,신세계IC,14100,14700,600,4.26,503665,7532028300
034300,신세계건설,26100,25750,-350,-1.34,111380,2919989300
031430,신세계인터내셔날,30700,28800,-1900,-6.19,2002897,60457918200
031440,신세계푸드,60000,62500,2500,4.17,92349,5747556700
006880,신송홀딩스,10700,10400,-300,-2.8,6416411,67582566820
005800,신영와코루,11550,12200,650,5.63,104669,1249580200
001720,신영증권,55900,56600,700,1.25,28064,1590408700
001725,신영증권우,57500,57300,-200,-0.35,4664,269673800
009270,신원,1710,1780,70,4.09,8696002,15414094885
002700,신일전자,2055,1910,-145,-7.06,22656357,43795264410
019170,신풍제약,28300,28350,50,0.18,5495075,155544526000
019175,신풍제약우,45450,45000,-450,-0.99,44123,2023879600
002870,신풍제지,1770,1675,-95,-5.37,3598751,6239118545
404990,신한서부티엔디리츠,4730,4890,160,3.38,595656,2861485350
293940,신한알파리츠,7810,7950,140,1.79,1626961,12695994760
055550,신한지주,35700,35700,0,0.0,16789091,600812076400
004080,신흥,16150,16100,-50,-0.31,18278,292914950
102280,쌍방울,557,505,-52,-9.34,72808553,38768621029
003410,쌍용CE,6670,6970,300,4.5,5487062,37902264430
003620,쌍용차,2770,2770,0,0.0,0,0
004770,써니전자,2825,2750,-75,-2.65,9445482,27302800040
015540,쎌마테라퓨틱스,6410,6410,0,0.0,0,0
004920,씨아이테크,1300,1060,-240,-18.46,11219626,13474153375
112610,씨에스윈드,55500,64500,9000,16.22,5871737,365238420100
008700,아남전자,2620,2515,-105,-4.01,72598309,202624425525
002790,아모레G,36900,35550,-1350,-3.66,1525996,54768749800
00279K,아모레G3우전환,30850,29200,-1650,-5.35,27482,819056450
002795,아모레G우,14250,14150,-100,-0.7,70736,999161450
090430,아모레퍼시픽,129000,127000,-2000,-1.55,2640217,334744298000
090435,아모레퍼시픽우,48000,48600,600,1.25,89992,4347397600
002030,아세아,124000,126000,2000,1.61,18159,2277200000
183190,아세아시멘트,11700,11950,250,2.14,2142130,26765679700
002310,아세아제지,36250,39300,3050,8.41,283842,10843798800
012170,아센디오,1170,1245,75,6.41,3472259,4129946385
267850,아시아나IDT,14200,14250,50,0.35,157442,2241555900
020560,아시아나항공,15000,15150,150,1.0,3701786,56371997000
122900,아이마켓코리아,10350,10600,250,2.42,425350,4450280800
010780,아이에스동서,40300,39650,-650,-1.61,925247,37931239900
139990,아주스틸,11950,11450,-500,-4.18,995998,11837650800
001780,알루코,3115,3140,25,0.8,5883014,18636726520
018250,애경산업,14850,14300,-550,-3.7,363984,5239394550
161000,애경케미칼,8350,9950,1600,19.16,2096720,19315398200
011090,에넥스,1400,1385,-15,-1.07,17979514,28029096040
137310,에스디바이오센서,40300,36600,-3700,-9.18,5944517,232050696050
005850,에스엘,31350,36150,4800,15.31,5327307,181590416000
010580,에스엠벡셀,1530,1530,0,0.0,0,0
012750,에스원,63800,60100,-3700,-5.8,674319,41929920250
023960,에쓰씨엔지니어링,2140,2230,90,4.21,4894630,11190395780
298690,에어부산,1385,3660,2275,164.26,1231506,4715333065
140910,에이리츠,5410,5710,300,5.55,53864,302082280
078520,에이블씨엔씨,5310,5350,40,0.75,251346,1325816250
015260,에이엔피,2180,2270,90,4.13,905570,2034289200
007460,에이프로젠,1525,1480,-45,-2.95,72625386,111276965490
003060,에이프로젠제약,672,640,-32,-4.76,16913674,11361629239
244920,에이플러스에셋,5930,6190,260,4.38,1652175,10506173220
036570,엔씨소프트,372500,374500,2000,0.54,1808721,701817270000
380440,엔에이치스팩19호,2100,2085,-15,-0.71,848382,1766829940
085310,엔케이,965,1085,120,12.44,26886265,30146767477
900140,엘브이엠씨홀딩스,2950,3060,110,3.73,2392245,7324831265
097520,엠씨넥스,33250,36350,3100,9.32,930531,32515362900
014440,영보화학,3810,4300,490,12.86,5859756,24726173955
111770,영원무역,40350,46900,6550,16.23,2267353,99691324850
009970,영원무역홀딩스,48000,53200,5200,10.83,418856,20707355700
003520,영진약품,3565,3515,-50,-1.4,3725839,13367441090
000670,영풍,549000,612000,63000,11.48,15339,8896690000
006740,영풍제지,7470,7020,-450,-6.02,2068754,15239022780
012280,영화금속,1155,1160,5,0.43,2937694,3501901845
012160,영흥,828,855,27,3.26,1545471,1308836384
015360,예스코홀딩스,35650,35350,-300,-0.84,38411,1351456250
007310,오뚜기,449500,486500,37000,8.23,249071,112936777500
002630,오리엔트바이오,815,787,-28,-3.44,4270416,3494702510
271560,오리온,100500,110000,9500,9.45,1928172,200801709100
001800,오리온홀딩스,15050,15500,450,2.99,871751,13091015400
011690,와이투솔루션,649,735,86,13.25,39625061,31909733427
070960,용평리조트,4085,3910,-175,-4.28,496495,2002453550
316140,우리금융지주,11900,12450,550,4.62,29147438,352154760346
010050,우리종금,914,913,-1,-0.11,45342268,42890383715
006980,우성,24700,25600,900,3.64,108980,2764734950
017370,우신시스템,2550,2545,-5,-0.2,609711,1607959055
105840,우진,13000,13000,0,0.0,20173649,269338385250
010400,우진아이엔에스,6460,6510,50,0.77,1815948,13175606580
049800,우진플라임,3700,4455,755,20.41,5754336,25254918600
016880,웅진,1515,1565,50,3.3,25795130,42171467295
095720,웅진씽크빅,2545,2680,135,5.3,6283468,16821068615
005820,원림,26500,23750,-2750,-10.38,48151,1193542150
010600,웰바이오텍,1820,1765,-55,-3.02,12452213,22207167865
008600,윌비스,984,996,12,1.22,2858215,2838044502
033270,유나이티드제약,25650,25200,-450,-1.75,571866,14855537750
014830,유니드,96100,96300,200,0.21,863911,83985581700
000910,유니온,6170,6220,50,0.81,21690169,143747498990
047400,유니온머티리얼,2575,3315,740,28.74,303777471,1036100010045
011330,유니켐,1185,1185,0,0.0,1618419,1922810515
077500,유니퀘스트,9340,9120,-220,-2.36,1372209,12888152490
002920,유성기업,2945,3005,60,2.04,189240,562576180
000700,유수홀딩스,5990,6400,410,6.84,466463,2916587060
003470,유안타증권,2885,2900,15,0.52,1152081,3357193685
003475,유안타증권우,3045,3065,20,0.66,60479,188933600
072130,유엔젤,3385,3515,130,3.84,9599802,38077752985
000220,유유제약,6810,6520,-290,-4.26,725738,4896717840
000225,유유제약1우,9320,9180,-140,-1.5,99490,929663860
000227,유유제약2우B,17550,17100,-450,-2.56,5483,95560250
001200,유진투자증권,2900,2940,40,1.38,1212341,3540729945
000100,유한양행,57800,57300,-500,-0.87,1937372,111928883200
000105,유한양행우,56600,56200,-400,-0.71,8474,477895000
003460,유화증권,2465,2505,40,1.62,147628,368115520
003465,유화증권우,2600,2650,50,1.92,10448,27345115
008730,율촌화학,23450,28900,5450,23.24,2108039,56336750600
008250,이건산업,9020,9070,50,0.55,705641,6536343240
025820,이구산업,3225,3190,-35,-1.09,2897689,9596057300
214320,이노션,45550,43200,-2350,-5.16,521471,22969013650
088260,이리츠코크렙,5610,5930,320,5.7,687104,3989128230
139480,이마트,113000,104000,-9000,-7.96,2225987,236546465500
007660,이수페타시스,7310,6850,-460,-6.29,24105719,176373122090
005950,이수화학,14850,16950,2100,14.14,8157487,134627115600
015020,이스타코,1395,1325,-70,-5.02,19482690,29302427930
093230,이아이디,1415,1545,130,9.19,17645938,27706589625
074610,이엔플러스,3145,2960,-185,-5.88,11826694,38570212535
102460,이연제약,26200,25700,-500,-1.91,3107872,86731456350
084680,이월드,2020,1995,-25,-1.24,5633282,11383093365
350520,이지스레지던스리츠,4670,4670,0,0.0,673449,3132084990
334890,이지스밸류리츠,5130,5180,50,0.97,736554,3764274530
000760,이화산업,16150,15700,-450,-2.79,15462,247305450
014990,인디에프,780,781,1,0.13,576240,449157738
101140,인바이오젠,2185,2070,-115,-5.26,6999624,16029213365
006490,인스코비,2035,2010,-25,-1.23,7517120,15706189925
023800,인지컨트롤스,8300,8090,-210,-2.53,579861,4839405480
034590,인천도시가스,27250,29050,1800,6.61,801732,22973399800
129260,인터지스,2940,3160,220,7.48,1615313,4943910500
023810,인팩,9010,8020,-990,-10.99,497678,4188198050
249420,일동제약,40050,37400,-2650,-6.62,16755849,664294410050
000230,일동홀딩스,32000,29700,-2300,-7.19,11824490,363970625550
013360,일성건설,3470,3570,100,2.88,30777028,124416134305
003120,일성신약,77800,80000,2200,2.83,12251,962414400
003200,일신방직,103000,101000,-2000,-1.94,116356,12080149000
007110,일신석재,1435,1515,80,5.57,11289489,17600341750
007570,일양약품,23750,22750,-1000,-4.21,492902,11670244850
007575,일양약품우,26400,25100,-1300,-4.92,13494,348154350
008500,일정실업,23300,22250,-1050,-4.51,16640,381883550
081000,일진다이아,22050,22250,200,0.91,399005,8869087150
020760,일진디스플,2130,1895,-235,-11.03,10586886,22156374555
020150,일진머티리얼즈,73500,74000,500,0.68,4660930,348841167800
103590,일진전기,6720,5710,-1010,-15.03,9759837,60764655740
271940,일진하이솔루스,35550,35800,250,0.7,1189093,43320047100
015860,일진홀딩스,6610,6260,-350,-5.3,15179477,98113102720
226320,잇츠한불,16250,16050,-200,-1.23,318838,5268634950
317400,자이에스앤디,7920,8080,160,2.02,5209982,42128756820
033240,자화전자,25950,25500,-450,-1.73,2450608,61524079750
000950,전방,57000,53900,-3100,-5.44,16143,895054200
348950,제이알글로벌리츠,4700,4720,20,0.43,7712543,35791659595
194370,제이에스코퍼레이션,17100,18000,900,5.26,1162222,20690827100
025620,제이준코스메틱,962,901,-61,-6.34,8370751,8031439955
030000,제일기획,22800,22450,-350,-1.54,3525044,79627690400
271980,제일약품,23200,22400,-800,-3.45,235168,5432526000
001560,제일연마,9270,8780,-490,-5.29,246394,2254348460
002620,제일파마홀딩스,13350,12550,-800,-5.99,96610,1275821650
006220,제주은행,5520,5490,-30,-0.54,6660405,37151346250
089590,제주항공,15000,15900,900,6.0,3044382,48225302250
004910,조광페인트,6300,8040,1740,27.62,1999799,15482921770
004700,조광피혁,43450,44250,800,1.84,11015,491445950
001550,조비,19600,19950,350,1.79,692838,14145761550
000480,조선내화,77600,78100,500,0.64,14565,1130960700
120030,조선선재,156500,148500,-8000,-5.11,1280659,210122339500
018470,조일알미늄,2190,2160,-30,-1.37,133079278,301276438880
002600,조흥,180500,178000,-2500,-1.39,778,140314500
185750,종근당,90100,89100,-1000,-1.11,203274,18387058700
063160,종근당바이오,30050,29450,-600,-2.0,171949,5234457150
001630,종근당홀딩스,59800,61700,1900,3.18,40012,2443954600
044380,주연테크,893,857,-36,-4.03,1650431,1457987635
013890,지누스,47400,47500,100,0.21,680638,32590576250
013870,지엠비코리아,5650,5780,130,2.3,484567,2810649840
071320,지역난방공사,32100,32550,450,1.4,36575,1197259900
035000,지투알,6000,6050,50,0.83,122181,736577890
088790,진도,3435,2820,-615,-17.9,934901,2952582810
003780,진양산업,7770,7300,-470,-6.05,886332,6729220090
010640,진양폴리,6310,6150,-160,-2.54,825625,5172698030
100250,진양홀딩스,3585,3450,-135,-3.77,935409,3299686870
051630,진양화학,3815,4030,215,5.64,534683,2165644155
272450,진에어,13800,15650,1850,13.41,4437703,68728659400
011000,진원생명과학,13300,12400,-900,-6.77,8119955,107227501750
002780,진흥기업,1725,1705,-20,-1.16,15470144,27411834640
002787,진흥기업2우B,14300,14400,100,0.7,9545,139235950
002785,진흥기업우B,5260,5480,220,4.18,18287,100330430
009310,참엔지니어링,836,950,114,13.64,7731711,7306655963
000650,천일고속,65100,65600,500,0.77,2433,157785000
033250,체시스,1040,1150,110,10.58,13393830,16386065225
118000,초록뱀헬스케어,914,901,-13,-1.42,3173890,2915548194
035720,카카오,74800,76700,1900,2.54,27821741,2207136835076
323410,카카오뱅크,30900,28650,-2250,-7.28,49674039,1493581929836
377300,카카오페이,62900,68800,5900,9.38,10511615,738074222500
006380,카프로,2955,2680,-275,-9.31,2697583,7668428060
109070,컨버즈,4100,4100,0,0.0,0,0
001620,케이비아이동국실업,678,655,-23,-3.39,822532,547212429
029460,케이씨,19450,18650,-800,-4.11,469117,8635066950
281820,케이씨텍,17800,17500,-300,-1.69,473835,8012965700
381970,케이카,19100,21850,2750,14.4,11059775,245571244000
145270,케이탑리츠,1110,1120,10,0.9,1279169,1431837555
417310,코람코더원리츠,5250,5500,250,4.76,514916,2771933990
357120,코람코에너지리츠,5650,5610,-40,-0.71,1247036,6971282830
007815,코리아써우,8190,7910,-280,-3.42,50346,409614870
007810,코리아써키트,20450,18800,-1650,-8.07,3521393,69087279050
00781K,코리아써키트2우B,8640,8700,60,0.69,8948,76891090
003690,코리안리,8810,8630,-180,-2.04,1359808,11825963870
192820,코스맥스,69100,65000,-4100,-5.93,1142890,77354843200
044820,코스맥스비티아이,9430,9060,-370,-3.92,326687,3034972060
005070,코스모신소재,53600,59100,5500,10.26,12386344,739845968300
005420,코스모화학,16900,20400,3500,20.71,34600275,714085330950
071950,코아스,971,972,1,0.1,817756,806743561
002020,코오롱,25050,26050,1000,3.99,313928,8155644000
003070,코오롱글로벌,19600,18550,-1050,-5.36,636745,11865495600
003075,코오롱글로벌우,30250,31800,1550,5.12,29441,900660150
002025,코오롱우,16950,17250,300,1.77,58434,995210950
120110,코오롱인더,54700,53200,-1500,-2.74,1886694,102450900500
120115,코오롱인더우,28900,28050,-850,-2.94,46382,1319683750
138490,코오롱플라스틱,11950,11050,-900,-7.53,3629514,42382845250
021240,코웨이,64100,65900,1800,2.81,1359589,87181590500
036420,콘텐트리중앙,35200,40700,5500,15.63,2778280,110098654600
031820,콤텍시스템,810,821,11,1.36,5910951,5043010343
192400,쿠쿠홀딩스,17250,16100,-1150,-6.67,364176,6053634350
284740,쿠쿠홈시스,31500,30400,-1100,-3.49,210374,6499805150
015590,큐로,405,413,8,1.98,5071848,2108237224
264900,크라운제과,8690,9490,800,9.21,5827862,60445638740
26490K,크라운제과우,11450,12250,800,6.99,1103243,14537107650
005740,크라운해태홀딩스,7200,7550,350,4.86,3535606,30158272770
005745,크라운해태홀딩스우,11550,11650,100,0.87,128348,1617363950
259960,크래프톤,233500,255000,21500,9.21,2280172,592424981000
020120,키다리스튜디오,9570,9780,210,2.19,14057086,148469090940
039490,키움증권,84500,87600,3100,3.67,619654,53697466800
014580,태경비케이,4330,4685,355,8.2,2569748,11806584705
015890,태경산업,6320,6620,300,4.75,7678900,51820035390
006890,태경케미컬,14550,13150,-1400,-9.62,2040646,27544792950
003240,태광산업,899000,869000,-30000,-3.34,5690,5034911000
011280,태림포장,3395,3490,95,2.8,1760591,6090512955
004100,태양금속,1390,1395,5,0.36,2628585,3693003635
004105,태양금속우,2510,2445,-65,-2.59,104993,258620060
009410,태영건설,6850,6780,-70,-1.02,3545160,25329923720
009415,태영건설우,9720,9690,-30,-0.31,2255268,26657741090
001420,태원물산,5050,4995,-55,-1.09,92161,460973125
007980,태평양물산,1825,1875,50,2.74,1294638,2391237915
055490,테이팩스,75300,81800,6500,8.63,322581,25707271700
078000,텔코웨어,9780,9770,-10,-0.1,134627,1348741960
214420,토니모리,4045,4020,-25,-0.62,820545,3399369235
019180,티에이치엔,3145,3340,195,6.2,2318189,7928345900
363280,티와이홀딩스,18450,18350,-100,-0.54,615746,11553430750
36328K,티와이홀딩스우,16100,17450,1350,8.39,38428,671831650
091810,티웨이항공,1980,2040,60,3.03,4962046,10196866750
004870,티웨이홀딩스,543,530,-13,-2.39,4966716,2641411157
005690,파미셀,11500,13050,1550,13.48,23041554,317150567900
036580,팜스코,5180,5250,70,1.35,4142307,22550275670
004720,팜젠사이언스,7590,7650,60,0.79,1092692,8541853150
028670,팬오션,5650,5520,-130,-2.3,36699956,207535372070
010820,퍼스텍,3740,4000,260,6.95,77931402,322310303025
016800,퍼시스,31650,31200,-450,-1.42,44045,1389030600
001020,페이퍼코리아,1695,1990,295,17.4,8712643,16194092330
090080,평화산업,1755,1660,-95,-5.41,17394565,29748693220
010770,평화홀딩스,3875,3525,-350,-9.03,583634,2183030850
058430,포스코스틸리온,37100,38300,1200,3.23,869612,34796304100
047050,포스코인터내셔널,20550,26750,6200,30.17,22395936,533038839650
003670,포스코케미칼,131500,157000,25500,19.39,11826934,1786208170500
017810,풀무원,13500,14100,600,4.44,765124,10827340050
103140,풍산,27700,28400,700,2.53,1503218,41442664450
005810,풍산홀딩스,27450,27900,450,1.64,174808,4814471050
950210,프레스티지바이오파마,11900,11300,-600,-5.04,1749479,21810356400
009810,플레이그램,1175,1090,-85,-7.23,5235029,5831280350
086790,하나금융지주,37200,38500,1300,3.49,16464370,637043864797
293480,하나제약,18150,17550,-600,-3.31,213961,3816862450
039130,하나투어,49850,50000,150,0.3,1630165,81948391800
352820,하이브,175500,186500,11000,6.27,4005174,714991794500
071090,하이스틸,4215,4060,-155,-3.68,12990730,59044142640
019490,하이트론,2470,2470,0,0.0,0,0
000080,하이트진로,30250,30400,150,0.5,4060449,126213883168
000087,하이트진로2우B,18350,19100,750,4.09,17846,339015950
000140,하이트진로홀딩스,11650,11550,-100,-0.86,283324,3315192450
000145,하이트진로홀딩스우,14900,14750,-150,-1.01,4205,62943900
152550,한국ANKOR유전,1585,1595,10,0.63,48831,77740435
036460,한국가스공사,37200,41050,3850,10.35,4872310,188755496650
005430,한국공항,38100,40300,2200,5.77,79188,3126486450
071050,한국금융지주,63100,60800,-2300,-3.65,2310899,142533381100
071055,한국금융지주우,57000,56900,-100,-0.18,82406,4654063700
010040,한국내화,3285,3355,70,2.13,377731,1263992920
025540,한국단자,56200,62800,6600,11.74,268230,16077359800
004090,한국석유,11250,11600,350,3.11,1599981,18462102700
002200,한국수출포장,23000,24650,1650,7.17,64703,1576763450
002960,한국쉘석유,248000,255000,7000,2.82,12767,3212080500
000240,한국앤컴퍼니,12300,13400,1100,8.94,1115154,14637632400
123890,한국자산신탁,3460,3705,245,7.08,1933194,6989450795
015760,한국전력,22350,21500,-850,-3.8,13560666,295521747950
006200,한국전자홀딩스,1455,1530,75,5.15,3541514,5384943560
009540,한국조선해양,84700,92000,7300,8.62,2534468,228650629100
023350,한국종합기술,7000,7130,130,1.86,5326839,40769253500
025890,한국주강,2695,2790,95,3.53,283113,785235330
000970,한국주철관,8070,8300,230,2.85,3698266,31285656110
104700,한국철강,6810,6940,130,1.91,1282591,9054634530
017960,한국카본,13950,15100,1150,8.24,18604419,276312617800
161890,한국콜마,38850,39800,950,2.45,1353189,51976221200
024720,한국콜마홀딩스,17850,17150,-700,-3.92,326254,5638936400
161390,한국타이어앤테크놀로지,34800,39100,4300,12.36,5189610,199238135990
034830,한국토지신탁,1675,1705,30,1.79,7281051,12311279845
007280,한국특강,2455,2490,35,1.43,1208985,2927508530
168490,한국패러랠,2200,2215,15,0.68,312418,683195090
010100,한국프랜지,2590,2700,110,4.25,892061,2375477685
047810,한국항공우주,57000,56300,-700,-1.23,23460409,1351379598600
123690,한국화장품,7150,7250,100,1.4,263624,1919784090
003350,한국화장품제조,21700,22000,300,1.38,79400,1746024000
011500,한농화성,13500,13950,450,3.33,1095232,15472729200
002390,한독,18150,18200,50,0.28,192098,3553549150
014790,한라,4145,4235,90,2.17,8733535,39829806065
060980,한라홀딩스,38850,39250,400,1.03,161333,6287710400
053690,한미글로벌,11800,13500,1700,14.41,6703934,85535914000
042700,한미반도체,13500,12650,-850,-6.3,4909139,63822565000
008930,한미사이언스,40900,41500,600,1.47,905621,37577854700
128940,한미약품,309500,310500,1000,0.32,346026,108904600000
009240,한샘,57400,55000,-2400,-4.18,1159711,64552855100
020000,한섬,31100,29000,-2100,-6.75,1179675,35238699050
003680,한성기업,6420,6720,300,4.67,4137888,28798722950
105630,한세실업,16750,16800,50,0.3,7394181,129529103750
069640,한세엠케이,3680,3515,-165,-4.48,165910,593644620
016450,한세예스24홀딩스,5940,5860,-80,-1.35,248149,1453259860
010420,한솔PNS,1600,1735,135,8.44,1103550,1850125715
009180,한솔로지스틱스,3395,3345,-50,-1.47,5489077,19440192955
213500,한솔제지,14250,15150,900,6.32,1952392,28770871450
014680,한솔케미칼,219500,226000,6500,2.96,835914,186013608000
004710,한솔테크닉스,5980,6360,380,6.35,1992039,12521121710
004150,한솔홀딩스,3500,3500,0,0.0,689195,2388684100
025750,한솔홈데코,1415,1430,15,1.06,7380769,10553605350
004960,한신공영,12100,12350,250,2.07,1504783,19266688650
011700,한신기계,9070,9130,60,0.66,32756537,308093064240
001750,한양증권,11100,10300,-800,-7.21,244251,2619487950
001755,한양증권우,16300,16550,250,1.53,5037,83805150
018880,한온시스템,10650,10500,-150,-1.41,6493320,70026707700
009420,한올바이오파마,16350,16200,-150,-0.92,1944671,32114040550
014130,한익스프레스,5220,5260,40,0.77,422941,2209590720
300720,한일시멘트,14250,14850,600,4.21,5887698,94204934100
002220,한일철강,4100,4065,-35,-0.85,1056717,4511629865
006390,한일현대시멘트,25850,24550,-1300,-5.03,314274,8110976800
003300,한일홀딩스,10850,11500,650,5.99,43652,493667900
051600,한전KPS,38250,41900,3650,9.54,3802237,155435570000
052690,한전기술,65600,72800,7200,10.98,3999961,282731552200
130660,한전산업,10650,11350,700,6.57,3696905,41131764350
002320,한진,26800,27000,200,0.75,526393,14093717150
003480,한진중공업홀딩스,3970,4110,140,3.53,1089382,4473140060
180640,한진칼,60000,61000,1000,1.67,675097,41440927800
18064K,한진칼우,32900,33400,500,1.52,18134,607327100
005110,한창,1100,1110,10,0.91,136169599,158603715760
009460,한창제지,1735,1725,-10,-0.58,2216757,3840630940
372910,한컴라이프케어,5500,5480,-20,-0.36,486829,2681945020
000880,한화,27550,31200,3650,13.25,5914744,176327400650
00088K,한화3우B,15000,15850,850,5.67,725808,11269235100
088350,한화생명,2305,2345,40,1.74,20047179,45924863530
000370,한화손해보험,5010,4895,-115,-2.3,10020379,50283595035
009830,한화솔루션,43800,46600,2800,6.39,43080459,1960740112300
009835,한화솔루션우,48500,47350,-1150,-2.37,1677825,82069533600
272210,한화시스템,14550,15100,550,3.78,10946742,164191672900
012450,한화에어로스페이스,64400,70600,6200,9.63,27180064,1834723611000
000885,한화우,37250,35900,-1350,-3.62,23389,861453750
003530,한화투자증권,3335,3330,-5,-0.15,9813536,33173546115
003535,한화투자증권우,7530,7670,140,1.86,88969,672131990
195870,해성디에스,57500,60500,3000,5.22,3455307,203638295000
101530,해태제과식품,7050,7260,210,2.98,3562395,29127940370
143210,핸즈코퍼레이션,3985,4015,30,0.75,270667,1127889370
000720,현대건설,42150,46050,3900,9.25,11834579,543533129450
267270,현대건설기계,37900,38850,950,2.51,2630802,104207961950
000725,현대건설우,69700,71400,1700,2.44,52618,3780987100
005440,현대그린푸드,7730,7800,70,0.91,1660864,13015048030
086280,현대글로비스,182000,178000,-4000,-2.2,1690128,307734538500
042670,현대두산인프라코어,5570,5700,130,2.33,16759029,96173989760
064350,현대로템,26550,26050,-500,-1.88,65079878,1669795442200
079430,현대리바트,11650,11400,-250,-2.15,514684,5903939900
012330,현대모비스,228500,214500,-14000,-6.13,3355611,741079468000
010620,현대미포조선,89900,109500,19600,21.8,5164400,528764215200
069960,현대백화점,66600,65200,-1400,-2.1,1275941,84242098100
004560,현대비앤지스틸,13450,13850,400,2.97,1587630,22251355800
004565,현대비앤지스틸우,61600,60800,-800,-1.3,5226,319468700
004310,현대약품,5460,5340,-120,-2.2,7157672,40361462140
322000,현대에너지솔루션,50500,55000,4500,8.91,12131061,653954125000
017800,현대엘리베이,28150,28700,550,1.95,1324873,38678045550
307950,현대오토에버,125500,118000,-7500,-5.98,1528734,193267422500
011210,현대위아,68100,68200,100,0.15,2488185,173126807800
267260,현대일렉트릭,27450,30000,2550,9.29,6225358,178326027850
004020,현대제철,34100,32900,-1200,-3.52,5976257,202154901450
329180,현대중공업,125000,138500,13500,10.8,3272126,444110510500
005380,현대차,196000,190000,-6000,-3.06,11140152,2149936730500
005387,현대차2우B,94200,90600,-3600,-3.82,932547,86536266600
005389,현대차3우B,89800,86500,-3300,-3.67,103004,9032589800
005385,현대차우,94100,89600,-4500,-4.78,754020,69173108900
001500,현대차증권,10650,10500,-150,-1.41,441863,4625340150
011760,현대코퍼레이션,15900,17700,1800,11.32,1085399,18592941650
227840,현대코퍼레이션홀딩스,11100,11850,750,6.76,328423,3754863450
126560,현대퓨처넷,2780,2830,50,1.8,28719364,86825458975
001450,현대해상,32800,34550,1750,5.34,5234824,176661413750
057050,현대홈쇼핑,52300,51700,-600,-1.15,135440,6946654400
093240,형지엘리트,1670,1715,45,2.69,4231679,7379410305
003010,혜인,7790,7430,-360,-4.62,9017803,70875694840
111110,호전실업,9050,8960,-90,-0.99,576042,5233178160
008770,호텔신라,71800,71900,100,0.14,2087581,150962675200
008775,호텔신라우,59400,59500,100,0.17,17459,1044029400
002460,화성산업,17400,16450,-950,-5.46,683354,11751138400
378850,화승알앤에이,3410,3600,190,5.57,4961872,19037077790
241590,화승엔터프라이즈,12050,13400,1350,11.2,3863120,49657251750
006060,화승인더,5070,5290,220,4.34,2027538,10428086435
013520,화승코퍼레이션,1450,1595,145,10.0,2819367,4407646795
010690,화신,9570,9790,220,2.3,12759026,129091581040
133820,화인베스틸,2565,2880,315,12.28,2780595,7873872450
010660,화천기계,2920,3460,540,18.49,25003479,84345506175
000850,화천기공,34050,33200,-850,-2.5,109199,3807841350
016580,환인제약,17150,17150,0,0.0,279376,4776203000
032560,황금에스티,7520,7890,370,4.92,1468207,11454328350
004800,효성,76700,76300,-400,-0.52,567437,42721987600
094280,효성ITX,15100,15550,450,2.98,126130,1915128700
298040,효성중공업,60000,69500,9500,15.83,913191,59244907000
298050,효성첨단소재,393000,411500,18500,4.71,457667,187553996000
298020,효성티앤씨,344500,322000,-22500,-6.53,532474,173596895000
298000,효성화학,184500,183500,-1000,-0.54,137747,25761099000
093370,후성,18500,15900,-2600,-14.05,45103218,746198426950
081660,휠라홀딩스,30400,30350,-50,-0.16,4260800,131962366050
005870,휴니드,7980,8080,100,1.25,2099471,16926384050
079980,휴비스,6450,6140,-310,-4.81,342989,2191695610
005010,휴스틸,4010,6500,2490,62.09,25378239,149235171405
000540,흥국화재,3315,3515,200,6.03,991140,3439783790
000547,흥국화재2우B,22000,22100,100,0.45,4940,108995350
000545,흥국화재우,6980,7280,300,4.3,6747,48246800
003280,흥아해운,1830,1820,-10,-0.55,5039140,9212199565
